NO	./textures/path_no.xpm
SO	./textures/path_so.xpm
EA	./textures/path_ea.xpm
WE	./textures/path_we.xpm

C	66,75,91
F	86,71,65

11111111111
100101000011
100101000001
11000100N011
10001 10001
100001100011
10010000111
10010000001
111111111111